    #####
    #   #
    #$  #
  ###  $##
  #  $ $ #
### # ## #   ######
#   # ## #####  ..#
# $  $          ..#
##### ### #@##  ..#
    #     #########
    #######
1;
############
#..  #     ###
#..  # $  $  #
#..  #$####  #
#..    @ ##  #
#..  # #  $ ##
###### ##$ $ #
  # $  $ $ $ #
  #    #     #
  ############
; 2
      ####
####### @#
#     $  #
#   $## $#
##$#...# #
 # $...  #
 # #. .# ##
 #   # #$ #
 #$  $    #
 #  #######
 ####
 38;
       #####
 #######   ##
## # @## $$ #
#    $      #
#  $  ###   #
### #####$###
# $  ### ..#
# $ $ $ ...#
#    ###...#
# $$ # #...#
#  ### #####
####
7;

   ##########
   #..  #   #
   #..      #
   #..  #  ####
  #######  #  ##
  #            #
  #  #  ##  #  #
#### ##  #### ##
#  $  ##### #  #
# # $  $  # $  #
# @$  $   #   ##
#### ## #######
   #    #
   ######
17;
       ###########
       #         #
       #    $ $  #
###### # $ ##### #
#    ##### $  ##$#
#       $ $      #
#          ## ## #
#    ##@##### ## #
#    ####   # ## ##
#....#      # $   #
#....#      #     #
######      #######
78;
############
#..  #     ###
#..  # $  $  #
#..  #$####  #
#..    @ ##  #
#..  # #  $ ##
###### ##$ $ #
  # $  $ $ $ #
  #    #     #
  ############
; 2

        ########
        #     @#
        # $#$ ##
        # $  $#
        ##$ $ #
######### $ # ###
#....  ## $  $  #
##...    $  $   #
#....  ##########
########
; 3

           ########
           #  ....#
############  ....#
#    #  $ $   ....#
# $$$#$  $ #  ....#
#  $     $ #  ....#
# $$ #$ $ $########
#  $ #     #
## #########
#    #    ##
#     $   ##
#  $$#$$  @#
#    #    ##
###########
; 4
######  ###
#..  # ##@##
#..  ###   #
#..     $$ #
#..  # # $ #
#..### # $ #
#### $ #$  #
   #  $# $ #
   # $  $  #
   #  ##   #
   #########
; 6
  #################
###@##         ...#
#    #         ...#
# $  #         ...#
# $$ #         ...#
## $ ###$##########
 # ###  $ #
##   $  $ #
#  $ #  $ #
# $  #    #
#  $ #    #
#    #    #
###########
; 80
    ######
 ####    #
 #    ## #
 # $     #
### #### ########
#  $   $ ##  ...#
#   $$ $$    ...#
#    $  $##  ...#
##@## ## ##  ...#
 ###  $  ########
 #   $$  #
 #    #  #
 #########
; 82

####### #########
#     # #   ##  #
# ### # #   $   #
# # $ ###   $   #
#   $$      ##$ #
#    ####   ##  #
#@############ ##
###..    #####$ #
  #..    ####   #
  #..       $$  #
  #..    #### $ #
  #..    #  #   #
  ########  #####
 83