    #####
    #   #
    #$  #
  ###  $##
  #  $ $ #
### # ## #   ######
#   # ## #####  ..#
# $  $          ..#
##### ### #@##  ..#
    #     #########
    #######
1;    
       ###########
       #         #
       #    $ $  #
###### # $ ##### #
#    ##### $  ##$#
#       $ $      #
#          ## ## #
#    ##@##### ## #
#    ####   # ## ##
#....#      # $   #
#....#      #     #
######      #######
 78